
P11111111111111111111111111111111111111111111111111
111111111111111111111111111111111111111111111111111
111111111111111111111111111111111111111111111111111
111111111111111111111111111111111111111111111111111
111111111111111111111111111111111111111111111111111
333333333333333333333333333333333333333333333333333
333333333333333333333333333333333333333333333333333
333333333333333333333333333333333333333333333333333
222222222222222222222222222222222222222222222222222
333333333333333333333333333333333333333333333333333
111111111111111111111111111111111111111111111111111
333333333333333333333333333333333333333333333333333
333333333333333333333333333333333333333333333333333
444444444444444444444444444444444444444444444444444
333333333333333333333333333333333333333333333333333
111111111111111111111111111111111111111111111111111
111111111111111111111111111111111111111111111111111
222222222222222222222222222222222222222222222222222
222222222222222222222222222222222222222222222222222
111111111111111111111111111111111111111111111111111
111111111111111111111111111111111111111111111111111
444444444444444444444444444444444444444444444444444
111111111111111111111111111111111111111111111111111
222222222222222222222222222222222222222222222222222
111111111111111111111111111111111111111111111111111
111111111111111111111111111111111111111111111111111
111111111111111111111111111111111111111111111111111
222222222222222222222222222222222222222222222222222
333333333333333333333333333333333333333333333333333
333333333333333333333333333333333333333333333333333
111111111111111111111111111111111111111111111111111
222222222222222222222222222222222222222222222222222
222222222222222222222222222222222222222222222222222
111111111111111111111111111111111111111111111111111